10.ox
.o.....o.o
...o....o.
..o..oooo.
...o.o....
o...ooo...
....o..o..
o.........
.....oo.o.
o.......o.
...oo.....
